aanat	transferases_phase_II
abcb	abc_transporters
abcc	abc_transporters
abcg	abc_transporters
adh	oxygenases_phase_I
ahr	hlhpas_transcription_factors
ahrr	hlhpas_transcription_factors
akr	reductases_phase_I
aldh	oxygenases_phase_I
ar	nr_transcription_factors
arnt	hlhpas_transcription_factors
arntl	hlhpas_transcription_factors
bach	oxidative_stress_transcription_factors
cat	antioxidants
clock	hlhpas_transcription_factors
clpb	heat_responsive
clpp	heat_responsive
clpx	heat_responsive
cp	metal_response
crya	heat_responsive
cyp1	oxygenases_phase_I
cyp2	oxygenases_phase_I
cyp3	oxygenases_phase_I
cyp4	oxygenases_phase_I
dnaj	heat_responsive
ephx	reductases_phase_I
esr	nr_transcription_factors
esrr	nr_transcription_factors
fmo	oxygenases_phase_I
fth	metal_response
fthl	metal_response
gclc	antioxidants
gclm	antioxidants
gpx	antioxidants
grp78	heat_responsive
grp94	heat_responsive
gsr	antioxidants
gss	antioxidants
gsta	transferases_phase_II
gsta.	transferases_phase_II
gstk	transferases_phase_II
gstm	transferases_phase_II
gstm.	transferases_phase_II
gstp	transferases_phase_II
gstt	transferases_phase_II
gstz	transferases_phase_II
hif1a	hlhpas_transcription_factors
hmox	metal_response
hnf4	nr_transcription_factors
hsbp	heat_responsive
hsd	reductases_phase_I
hsdl	reductases_phase_I
hsf1	heat_responsive
hsf2	heat_responsive
hsf4	heat_responsive
hsf5	heat_responsive
hsp	heat_responsive
hspa	heat_responsive
hspb	heat_responsive
hspd	heat_responsive
hspe	heat_responsive
hspg	heat_responsive
hsph	heat_responsive
keap	oxidative_stress_transcription_factors
maff	oxidative_stress_transcription_factors
mafg	oxidative_stress_transcription_factors
mafk	oxidative_stress_transcription_factors
mgst	transferases_phase_II
mt	metal_response
mtf	metal_response
nat	transferases_phase_II
ncoa	hlhpas_transcription_factors
nfe	oxidative_stress_transcription_factors
nfkb	oxidative_stress_transcription_factors
nme8	antioxidants
npas	hlhpas_transcription_factors
nqo	reductases_phase_I
nr1a	nr_transcription_factors
nr1b	nr_transcription_factors
nr1c	nr_transcription_factors
nr1h	nr_transcription_factors
nr1i	nr_transcription_factors
nr2a	nr_transcription_factors
nr2b	nr_transcription_factors
nr3a	nr_transcription_factors
nr3b	nr_transcription_factors
nr3c	nr_transcription_factors
per	hlhpas_transcription_factors
pgr	nr_transcription_factors
ppara	nr_transcription_factors
ppard	nr_transcription_factors
pparg	nr_transcription_factors
prdx	antioxidants
ptgs	oxygenases_phase_I
pxr	nr_transcription_factors
rara	nr_transcription_factors
rarb	nr_transcription_factors
rarg	nr_transcription_factors
rxr	nr_transcription_factors
serpinh1b	heat_responsive
sim	hlhpas_transcription_factors
slc21	ion_metal_transporters
slc22	ion_metal_transporters
slc30	ion_metal_transporters
slc31	ion_metal_transporters
slc39	ion_metal_transporters
slc47	ion_metal_transporters
slco	ion_metal_transporters
sod	antioxidants
sult	transferases_phase_II
tfa	metal_response
thra	nr_transcription_factors
thraa	nr_transcription_factors
thrab	nr_transcription_factors
thrac	nr_transcription_factors
thrb	nr_transcription_factors
thrba	nr_transcription_factors
thrbb	nr_transcription_factors
txn	antioxidants
txnl	antioxidants
ugt	transferases_phase_II
vdr	nr_transcription_factors
